322122111323222
113113111333321
211311525231112
332212444413212
211231444421221
112225444433113
131233444453133
122322235112112
123333312221321
132132322212221
323122123311213